┏━━━━━━━━━━━━━━━━━━┳━━━━━━━━━━━━━━━━━━━━━━━━━━┳━━━━━━━━━━━━━━━━┓
┃                  │                          │                ┃
┃                  │                          │                ┃
┃                  │                          │                ┃
┃                  │                          │                ┃
┣──────────────────┘                          │                ┃
┃                                             │                ┃
┃                                             │                ┃
┃                                             │                ┃
┃                                                              ┃
┃                                                              ┃
┃                                                              ┃
┃                                                              ┃
┃                                       ┌────────────          ┃
┃             │                         │                      ┃
┃             │                         │                      ┃
┃             │                         │                      ┃
┃             │                         │                      ┃
┃             │                         │                      ┃
┃             │                         │                      ┃
┃             │                         │                      ┃
┗━━━━━━━━━━━━━┻━━━━━━━━━━━━━━━━━━━━━━━━━┻━━━━━━━━━━━━━━━━━━━━━━┛